1111111111111111111111111111111111111111111111
1100000000000000000100000000000000000000000001
1000000000000000000100000000000000000000000001
1000000000000100000100000000000000010000000001
1000000000000100000000000000000000010000000001
1000000000000100000000000000000000010000000001
1000000111111111111111111111111111110000000001
1000000100000000000000000000000000010000000001
1000000100000000000000000000000000010000000001
1000000100000000000000000000000000010000000001
1222222100000000000000000000000000010000000001
1009000100000000000000000000000000010000000001
1000000100000000000000000000000000010000000001
1000000100000000000000000000000000010000000001
1000000100000000000000000000000000010000000001
1000000100000000000000000000000000010000000001
1000000111111111111111111111111111110000000001
1000000000000000000000000000010000000000000001
1000000000000000000000000000010000000000000001
1000000000100000000000000000000000000000000001
1000000000100000000000000000000000000000000001
1111111111111111111111111111111111111111111111
