111111111111111111111111111111111111111111111111111111111111111
100000000000000000000000000000000000000000000000000000000000001
100000000000000000000000000000000000000000000000000000000000001
100000000000000000000000000000000000000000000000000000000000001
100000000000000000000000000000000000000000000000000000000000001
100000000000000000000000000000000000000000000000000000000000001
100000011111111111111111111111111111111111111111111110000000001
100000010000000000000000000000000000000000000000000010000000001
100000010000000000000000000000000000000000000000000010000000001
100000010000000000000000000000000000000000000000000010000000001
100000010000000000000000000000000000000000000000000010000000001
100000010000000000000000000000000000000000000000000010000000001
100000010000000000000000000000000000000000000000000010000000001
100000010000000000000000000000000000000000000000000010000000001
100000010000000000000000000000000000000000000000000010000000001
100000010000000000000000000000000000000000000000000010000000001
100000010000000000000000000000000000000000000000000010000000001
100000010000000000000000000000000000000000000000000010000000001
100000010000000000000000000000000000000000000000000010000000001
100000010000000000000000001100000000000000000000000010000000001
100000010000000000000000001100000000000000000000000010000000001
100000010000000000000000000000000000000000000000000010000000001
100000010000000000000000000000000000000000000000000010000000001
100000010000000000000000000000000000000000000000000010000000001
100000010000000000000000000000000000000000000000000010000000001
100000010000000000000000000000000000000000000000000010000000001
100000010000000000000000000000000000000000000000000010000000001
100000010000000000000000000000000000000000000000000010000000001
122222210000000000000000000000000000000000000000000010000000001
100900010000000000000000000000000000000000000000000010000000001
100000010000000000000000000000000000000000000000000010000000001
100000010000000000000000000000000000000000000000000010000000001
100000010000000000000000000000000000000000000000000010000000001
100000010000000000000000000000000000000000000000000010000000001
100000010000000000000000000000000000000000000000000010000000001
100000010000000000000000000000000000000000000000000010000000001
100000010000000000000000000000000000000000000000000010000000001
100000010000000000000000000000000000000000000000000010000000001
100000010000000000000000000000000000000000000000000010000000001
100000010000000000000000000000000000000000000000000010000000001
100000010000000000000000000000000000000000000000000010000000001
100000010000000000000000000000000000000000000000000010000000001
100000010000000000000000000000000000000000000000000010000000001
100000010000000000000000000000000000000000000000000010000000001
100000010000000000000000000000000000000000000000000010000000001
100000010000000000000000000000000000000000000000000010000000001
100000010000000000000000000000000000000000000000000010000000001
100000010000000000000000000000000000000000000000000010000000001
100000010000000000000000000000000000000000000000000010000000001
100000010000000000000000000000000000000000000000000010000000001
100000010000000000000000000000000000000000000000000010000000001
100000010000000000000000000000000000000000000000000010000000001
100000010000000000000000000000000000000000000000000010000000001
100000010000000000000000000000000000000000000000000010000000001
100000010000000000000000000000000000000000000000000010000000001
100000010000000000000000000000000000000000000000000010000000001
100000011111111111111111111111111111111111111111111110000000001
100000000000000000000000000000000000000000000000000000000000001
100000000000000000000000000000000000000000000000000000000000001
100000000000000000000000000000000000000000000000000000000000001
100000000000000000000000000000000000000000000000000000000000001
100000000000000000000000000000000000000000000000000000000000001
100000000000000000000000000000000000000000000000000000000000001
111111111111111111111111111111111111111111111111111111111111111