111111111111111111111111111111111111111111111111111111111111111
100000000000000000000000000000000000000000000000000000000000001
100000000000000000000000000000000000000000000000000000000000001
100000000000000000000000000000000000000000000000000000000000001
100000000000000000000000000000000000000000000000000000011000001
100000000000000000000000000000000000000000000000000000110000001
100000000000000000000000000000000000000000000000000001100000001
100000011111111111111111111111111111111111111111111111000000001
100000010000000000000000000100000000000000000000000000000000001
100000010000000000000000000100000000000000000000000000000000001
100000010000000000000000000100000000000000000000000000000000001
100000010000000000000000000100000000000000000000000000000000001
100000010000000000000000000100000011111111111111111111111111111
122222210000000010000000000100000000000000000000000000000000001
100900010000000010000000000100000000000000000000000000000000001
100000010000000010000000000100000000000000000000000000000000001
100000010000000010000000000100000000000000000000000000000000001
100000010000000010000000000111111111111111111111111111100000001
100000010000000010000000000000000000000000000000000000000000001
100000010000000010000000000000000000000000000000000000000000001
100000010000000010000000000000000000000000000000000000000000001
100000010000000010000000000000000000000000000000000000000000001
100000010000000011111111111111111111111111111111111111111111111
100000010000000000000000000000000000000000000010000000000000001
100000010000000000000000000000000000000000000010000000000000001
100000010000000000000000000000000000000000000010000000000000001
100000010000000000000003000000000000000000000010000000000000001
100000010000000000000000000000000000000000000010000000000000001
100000010000000000000000000000000000000000000010000000100000001
100000011111111111111111111111111111111000000010000000100000001
100000010000000000000000000000000000001000000010000000100000001
100000010000000000000000000000000000001000000010000000100000001
100000010000000000000000000000000000001000000000000000100000001
100000010000000000000000000000000000001000000000000000100000001
100000010000000111111111111110000000001000000000000000100000001
100000010000000100000000000010000000001111111111111111100000001
100000010000000100000000000010000000000000000000110000100000001
100000010000000100000000000010000000000000000000011000100000001
100000010000000100000000000010000000000000000000001110100000001
100000010000000100000010000010000000000000000000000111100000001
100300010000000100000100000011111111111111111000000011000000001
100000010000000100001000000000000100000100011000000110000000011
100000010000000100000100000000000100000011100000001100000000111
100000010000000100000010000000000100000000000000011000000001101
100000010000000100000001000000000100000000000000110000000011001
100000010000000100000001000000000100000000000001100000000110001
100000010000000100000001000000000000000000000011000000001100001
100000010000000100000001000000000000000000000110000000011000001
100000010000000100000001000000000000000000001100000000110000001
100000010000000100000001111111111111111111111000000001100000001
100000010000000100000000000000000000000000000000000011000000001
100000010000000100000000000000000000000000000000000010000000001
100000010000000100000000000000000000000000000000000010000000001
100000010000000100000000000000000000000000000000000010000000001
100000010000000100000000000000000000000000000000000010000000001
100000010000000111111111111111111111111111111111111111111111111
100000010000000000000000000000000000000000000000000000000000001
100000010000000000000000000000000000000000000000000000000000001
100000010000000000000000000000000000000000000000000000000000001
100000011111111111111111111111111111111111111111111100000000001
100000010000000000000000100000000000000001000000000100000000001
100000010000000000000000100000000000000001000000000100000000001
100000010000000000000000100000000000000001000010000100000000001
100000010000011100000000100000111111000001000010000100000000001
100000010000000100000000100000000001000001000010000100000000001
100000010000000100000000100000000001000001000010000100000000001
100000010000000100000000100000000001000001000010000100000000001
100000010000000100000000111100000001000001000010000100000000001
100000010000000100000000000000000001000001000010000100000000001
100000011100000100000000000000000001000001000010000111111000001
100000000000000100000000000000000001000001000010000000001000001
100000000000000100000000100000000001000001000010000000000000001
100000000000000100000000100000000001000000000010000000000000001
100000000000000100000000100000000001000000000010000000000000001
111111111111111111111111111111111111111111111111111111111111111