111111111111111111111111111111111111111111111111111111111111111
100000000000000000100000000000000000000000000000000000000000001
100000000000000000100000000000000000000000000000000000000000001
100000000100000000100000000000000000000000000000000000000000001
100000000100000000100000000001111111111111111111111100000000001
100000000100000000100000000001000000000000000000000100000000001
100000000100000000000000000001000000000000000000000100000000001
100000000100000000000000000001000000000001000000000100000000001
100000000111111111111111111111000000000001000000000100000000001
100000000000000000000000000000000000000001000000000100000000001
100000000000000000000000000000000000000001000000000100000000001
111111111111111111111111111111111111111111000000000100000000001
100000000000000000000000000000000000000000000000000100000000001
100000000000000000000000000000000000000000000000000100000000001
100000000000000000000000000000000000000000000000000100000000001
100000000011111111111111111111111111111111111111111100000000001
100000000010000000000000000000000001000000000000000000000000001
100000000010000000000000000000000001000000000000000000000000001
100000000010000000000000000000000001000000000000000000000000001
100000000010000011111111110000000001000000000000000000000000001
100000000010000000000000010000000001000000011111111111111111111
100000000010000000000000010000000001000000000000000000000000001
100000000010000000000000010000000001000000000000000000000000001
100001111111111111100000010000000001000000000000000000000000001
100001000000000000100000010000000001111111111111111100000000001
100001000000000000100000010000000000000000000000000100000000001
100000000001000000000000010000000000000000000000000100000000001
100000000001000000000000010000000000000000000000000100000000001
100000000001000000000000010000000000000000000000000100000000001
111111111111111111111111111111111111111111111000000100000000001
100000000000000000000000000010000000000000000000000100000000001
100000000000000000000000000010000000000000000000000100000000001
100000000000000000000000000010000000000000000000000100000000001
100000000000000000000000000010000001111111111111111100000000001
100000001111111111100000000010000001100000000000000100000000001
100000000000000000100000000010000000000000000000000100000000001
100000000000000000100000000010000000000000000000000111100000001
100000000000000000100000000010000000000000000000000000100000001
111111111111110000100000000011111111111111111110000000100000001
100000000000000000100000000000000000000000000000000000100000001
100000000000000000100000000000000000000000000000000000100000001
100000000000000000100000000000000000000000000000000000100000001
100000011111111111111111111111111111111111111111111111100000001
100000010000000000000000010000000000000000000000000000000000001
100000010000000000000000010000000000000000000000000000000000001
100900010000000000000000010000000000000000000000000000000000001
100000010000000100000000010000001111111111111111111111111111111
100000010000000100000000010000001000000000000000000000000000001
100000010000000100000000010000001000000000000000000000000000001
100000010000000100000000010000001000000000000000000000000000001
100000010000000100000000010000001000000000111111111111111100001
100000010000000100000000000000001000000000100000000000000100001
100000010000000100000000000000001000000000100000000000000100001
100000010000000100000000000000001000000000100000000000000100001
100000010000000100000000000000001000000000100000001000000100001
100000010000000111111111111111111000000000100000001000000100001
100000010000000000000000000000000000000000100000001000000100001
100000010000000000000000000000000000000000100000001000000100001
100000010000000000000000000000000000000000100000001000000100001
100000011111111111111111111111111111111111100000001000000100001
100000000000000020000000000000000000000000000000001000000000001
100000000000000020000000000000000000000000000000001000000000001
100000000000000020000000000000000000000000000000001000000000001
111111111111111111111111111111111111111111111111111111111111111